University of Alabama	AL
Alabama State University	AL
Alabama AM University	AL
University of Alabama Birmingham	AL
Auburn University	AL
Jacksonville State University	AL
Samford University	AL
University of South Alabama	AL
Troy University	AL
University of Arizona	AZ
Arizona State University	AZ
Northern Arizona University	AZ
Grand Canyon University	AZ
Arkansas State University	AR
University of Central Arkansas	AR
University of Arkansas	AR
University of Arkansas Little Rock	AR
University of Arkansas Pine Bluff	AR
California Baptist University	CA
California Polytechnic State University	CA
California State University-Bakersfield	CA
California State University-Fresno	CA
California State University-Fullerton	CA
California State University-Long Beach	CA
California State University-Northridge	CA
California State University-Sacramento	CA
Long Beach State University	CA
Loyola Marymount University	CA
Pepperdine University	CA
Saint Mary's College of California	CA
San Diego State University	CA
San Jose State University	CA
Santa Clara University	CA
Stanford University	CA
University of California-Berkeley	CA
University of California-Davis	CA
University of California-Irvine	CA
University of California-Los Angeles	CA
University of California-Riverside	CA
University of California-Santa Barbara	CA
University of California-San Diego	CA
University of San Diego	CA
University of San Francisco	CA
University of Southern California	CA
University of the Pacific	CA
Colorado State University	CO
US Air Force Academy	CO
University of Colorado-Boulder	CO
University of Denver	CO
University of Northern Colorado	CO
Central Connecticut State University	CT
University of Connecticut	CT
University of Hartford	CT
Fairfield University	CT
Quinnipiac University	CT
Sacred Heart University	CT
Yale University	CT
University of Delaware	DE
Delaware State University	DE
American University	DC
George Washington University	DC
Georgetown University	DC
Howard University	DC
Bethune-Cookman University	FL
University of Central Florida	FL
University of Florida	FL
Florida AM University	FL
Florida Atlantic University	FL
Florida Gulf Coast University	FL
Florida International University	FL
Florida State University	FL
Jacksonville University	FL
University of Miami of Florida	FL
University of North Florida	FL
University of South Florida	FL
Stetson University
Georgia Institute of Technology	GA
Georgia Southern University	GA
Georgia State University	GA
Kennesaw State University	GA
Mercer University	GA
University of Georgia	GA
University of Hawaii-Manoa	HI
Boise State University	ID
University of Idaho	ID
Idaho State University	ID
Bradley University	IL
Chicago State University	IL
DePaul University	IL
Eastern Illinois University	IL
Illinois State University	IL
University of Illinois Urbana-Champaign	IL
University of Illinois Chicago	IL
Loyola University Chicago	IL
Northern Illinois University	IL
Northwestern University	IL
Southern Illinois University Carbondale	IL
Southern Illinois University Edwardsville	IL
Western Illinois University	IL
Ball State University	IN
Butler University	IN
Indiana State University	IN
Indiana University-Bloomington	IN
Indiana University-Purdue University at Indianapolis	IN
Purdue University	IN
Purdue University-Fort Wayne	IN
University of Evansville	IN
University of Notre Dame	IN
University of Southern Indiana	IN
Valparaiso University	IN
Drake University	IA
University of Iowa	IA
Iowa State University	IA
University of Northern Iowa	IA
University of Kansas	KS
Kansas State University	KS
Wichita State University	KS
Bellarmine University	KY
Eastern Kentucky University	KY
University of Kentucky	KY
University of Louisville	KY
Morehead State University	KY
Murray State University	KY
Northern Kentucky University	KY
Western Kentucky University	KY
University of Louisiana Lafayette	LA
University of Louisiana Monroe	LA
Louisiana State University	LA
Louisiana Tech University	LA
Grambling State University	LA
McNeese State University	LA
University of New Orleans	LA
Nicholls State University	LA
Northwestern State University	LA
Southeastern Louisiana University	LA
Southern University-Baton Rouge	LA
Tulane University	LA
University of Maine	ME
Coppin State University	MD
Loyola University Maryland	MD
University of Maryland Eastern Shore	MD
University of Maryland Baltimore County	MD
University of Maryland College Park	MD
Morgan State University	MD
Mount St Marys University	MD
Towson University	MD
US Naval Academy	MD
Boston College	MA
Boston University	MA
College of the Holy Cross	MA
Harvard University	MA
Merrimack College	MA
Northeastern University	MA
Stonehill College	MA
University of Massachusetts Amherst	MA
University of Massachusetts Lowell	MA
Central Michigan University	MI
University of Detroit Mercy	MI
Eastern Michigan University	MI
University of Michigan	MI
Michigan State University	MI
Oakland University	MI
Western Michigan University	MI
University of Minnesota Twin Cities	MN
University of St Thomas	MN
Alcorn State University	MS
Jackson State University	MS
Mississippi State University	MS
Mississippi Valley State University	MS
University of Mississippi	MS
University of Southern Mississippi	MS
Lindenwood University	MO
Missouri State University	MO
Saint Louis University	MO
University of Missouri Columbia	MO
University of Missouri Kansas City	MO
Southeast Missouri State University	MO
University of Montana	MT
Montana State University Bozeman	MT
Creighton University	NE
University of Nebraska Omaha	NE
University of Nebraska Lincoln	NE
University of Nevada Las Vegas	NV
University of Nevada Reno	NV
Dartmouth College	NH
University of New Hampshire	NH
Fairleigh Dickinson University Metropolitan Campus	NJ
Monmouth University	NJ
New Jersey Institute of Technology	NJ
Princeton University	NJ
Rider University	NJ
Rutgers (State University of New Jersey) New Brunswick	NJ
Seton Hall University	NJ
Saint Peters University	NJ
University of New Mexico	NM
New Mexico State University	NM
University at Albany	NY
Binghamton University	NY
University at Buffalo (State University of New York)	NY
Canisius College	NY
Colgate University	NY
Columbia University Barnard College	NY
Cornell University	NY
Fordham University	NY
Hofstra University	NY
Iona College	NY
Long Island University Brooklyn Campus	NY
Manhattan College	NY
Marist College	NY
Niagara University	NY
Siena College	NY
St Bonaventure University	NY
St Francis College Brooklyn	NY
St Johns University of New York	NY
Stony Brook University	NY
Syracuse University	NY
US Military Academy (West Point)	NY
Wagner College	NY
Appalachian State University	NC
Campbell University	NC
Davidson College	NC
Duke University	NC
East Carolina University	NC
Elon University	NC
Gardner-Webb University	NC
High Point University	NC
University of North Carolina Asheville	NC
North Carolina AT State University	NC
North Carolina Central University	NC
North Carolina State University	NC
North Carolina AT State University	NC
University of North Carolina Wilmington	NC
University of North Carolina Chapel Hill	NC
University of North Carolina Charlotte	NC
University of North Carolina Greensboro	NC
Wake Forest University	NC
Western Carolina University	NC
University of North Dakota	ND
North Dakota State University	ND
University of Akron	OH
Bowling Green State University	OH
University of Cincinnati	OH
Cleveland State University	OH
University of Dayton	OH
Kent State University	OH
Miami University of Ohio	OH
Ohio State University	OH
Ohio University	OH
University of Toledo	OH
Wright State University	OH
Xavier University	OH
Youngstown State University	OH
University of Oklahoma	OK
Oklahoma State University	OK
Oral Roberts University	OK
University of Tulsa	OK
University of Oregon	OR
Oregon State University	OR
University of Portland	OR
Portland State University	OR
Bucknell University	PA
Drexel University	PA
Duquesne University	PA
La Salle University	PA
Lafayette College	PA
Lehigh University	PA
University of Pennsylvania	PA
Pennsylvania State University	PA
University of Pittsburgh	PA
Robert Morris University	PA
Saint Francis University (PA)	PA
Saint Josephs University	PA
Temple University	PA
Villanova University	PA
Brown University	RI
Bryant University	RI
Providence College	RI
University of Rhode Island	RI
College of Charleston (South Carolina)	SC
Charleston Southern University	SC
Citadel	SC
Clemson University	SC
Coastal Carolina University	SC
Furman University	SC
Presbyterian College	SC
University of South Carolina Columbia	SC
South Carolina State University	SC
University of South Carolina Upstate	SC
Winthrop University	SC
Wofford College	SC
University of South Dakota	SD
South Dakota State University	SD
Austin Peay State University	TN
Belmont University	TN
East Tennessee State University	TN
Lipscomb University	TN
University of Memphis	TN
Middle Tennessee State University	TN
Tennessee State University	TN
Tennessee Technological University	TN
University of Tennessee Chattanooga	TN
University of Tennessee Knoxville	TN
University of Tennessee Martin	TN
Vanderbilt University	TN
Abilene Christian University	TX
Baylor University	TX
Houston Christian University	TX
Lamar University	TX
Prairie View AM University	TX
Rice University	TX
Sam Houston State University	TX
Southern Methodist University	TX
Stephen F Austin State University	TX
Tarleton State University	TX
Texas AM University College Station	TX
Texas AM University Commerce	TX
Texas AM University Corpus Christi	TX
Texas Christian University	TX
Texas Southern University	TX
Texas State University	TX
Texas Tech University	TX
University of Texas Rio Grande Valley	TX
University of Houston	TX
University of North Texas	TX
University of Texas Arlington	TX
University of Texas Austin	TX
University of Texas El Paso	TX
University of Texas San Antonio	TX
University of the Incarnate Word	TX
Brigham Young University	UT
Dixie State University	UT
Southern Utah University	UT
University of Utah	UT
Utah State University	UT
Utah Valley University	UT
Weber State University	UT
University of Vermont	VT
George Mason University	VA
Hampton University	VA
James Madison University	VA
Liberty University	VA
Longwood University	VA
Norfolk State University	VA
Old Dominion University	VA
Radford University	VA
University of Richmond	VA
University of Virginia	VA
Virginia Commonwealth University	VA
Virginia Military Institute	VA
Virginia Polytechnic Institute and State University	VA
College of William and Mary	VA
Eastern Washington University	WA
Gonzaga University	WA
Seattle University	WA
University of Washington	WA
Washington State University	WA
Marshall University	WV
West Virginia University	WV
Marquette University	WI
University of Wisconsin Green Bay	WI
University of Wisconsin Madison	WI
University of Wisconsin Milwaukee	WI
University of Wyoming	WY